	 	　				
I	我	我	我			
You	汝	汝	汝			
This	此	此	此			
That	彼	彼	彼			
It	其	其	其			
Any	某	某	某			
Self	自	自	自			
Together	相	相	相			
Person	人	人	人			
Body	身	身	身			
Frame	骨	骨	骨			
Head	首	首	首			
Hand	手	手	手			
Foot	足	足	足			
Sex	性	性	性			
Male	男	男	男			
Female	女	女	女	女		
Love	愛	愛	爱			
Mind	心	心	心			
Parent	母	母	母			
Child	子	子	子			
Sibling	族	族	族			
Mammal	獸	獣	兽			
Bird	鳥	鳥	鸟			
Reptile	爬	爬	爬			
Fish	魚	魚	鱼			
Bug	蟲	虫	虫			
Plant	草	草	草			
Tree	木	木	木			
Fruit	果	果	果			
Seed	核	核	核			
Grain	米	米	米			
Taste	味	味	味			
Sweet	甘	甘	甘			
Bitter	苦	苦	苦			
Acid	酸	酸	酸			
Salt	鹽	塩	盐			
Sky	天	天	天			
Land	地	地	地			
Sun	日	日	日			
Moon	月	月	月			
Day	晝	昼	昼			
Black	黑	黒	黑			
White	白	白	白			
Light	光	光	光			
Color	色	色	色			
Red	赤	赤	赤			
Yellow	黃	黄	黄			
Green	綠	緑	绿	綠		
Blue	靑	青	靑			
Water	水	水	水			
Cold	冷	冷	冷	冷		
Hot	熱	熱	热			
Fire	火	火	火			
Oil	油	油	油			
Nature	源	源	源			
Air	風	風	风			
Stone	石	石	石			
Metal	金	金	金	金		
Money	錢	銭	钱			
Electric	電	電	电			
Tool	機	機	机			
Thing	物	物	物			
Stick	棒	棒	棒			
Board	板	板	板			
Box	箱	箱	箱			
House	家	家	家			
Hole	穴	穴	穴			
Glass	透	透	透			
Gap	間	間	间			
Elastic	彈	弾	弹			
Cloth	衣	衣	衣			
Paper	紙	紙	纸			
Draw	畵	畵	畵			
Book	書	書	书			
Sign	號	号	号			
Sort	型	型	型			
Form	形	形	形			
Point	點	点	点			
Line	線	線	线			
Surface	皮	皮	皮			
Circle	圓	円	圆			
Curve	曲	曲	曲			
Slope	斜	斜	斜			
Direct	直	直	直			
Edge	界	界	界			
Way	道	道	道			
Flat	平	平	平			
Moral	禮	礼	礼	禮		
Rule	則	則	则			
Public	公	公	公			
System	組	組	组			
Main	主	主	主			
Represent	代	代	代			
Group	團	団	团			
Part	片	片	片			
Powder	粉	粉	粉			
Number	數	数	数	數		
One	一	一	一			
Two	二	二	二			
Three	三	三	三			
Four	四	四	四			
Five	五	五	五			
Ten	十	十	十			
All	全	全	全			
Each	各	各	各			
Amount	度	度	度	度		
Level	態	態	态			
Compare	比	比	比			
Value	値	値	値			
Most	最	最	最			
Special	特	特	特			
Big	大	大	大			
Small	小	小	小			
Long	長	長	长			
Short	短	短	短			
Many	多	多	多			
Few	少	少	少			
Wide	廣	広	广			
Narrow	狹	狭	狭			
Far	遠	遠	远			
Near	近	近	近			
Fast	速	速	速			
Slow	遲	遅	迟			
Weight	重	重	重			
Difficult	難	難	难			
Old	舊	旧	旧			
New	新	新	新			
Different	他	他	他			
Same	如	如	如			
Good	好	好	好			
Bad	惡	悪	恶	惡		
Stupid	愚	愚	愚			
Crazy	狂	狂	狂			
Dirty	汚	汚	汚			
Clean	淸	清	淸			
Power	力	力	力	力		
Holy	神	神	神			
Beauty	美	美	美			
Fun	樂	楽	乐	樂	樂	樂
Soft	安	安	安			
Hard	固	固	固			
Danger	危	危	危			
Fear	恐	恐	恐			
Sad	悲	悲	悲			
Angry	怒	怒	怒	怒		
Surprise	驚	驚	惊			
Feel	感	感	感			
See	見	見	见	見		
Hear	聞	聞	闻			
Smell	臭	臭	臭			
Eat	食	食	食			
Need	要	要	要			
Want	願	願	愿			
Believe	信	信	信			
Store	錄	録	录	錄		
Find	探	探	探			
Touch	觸	触	触			
Think	念	念	念	念		
Know	知	知	知			
Mean	意	意	意			
Study	學	学	学			
Ask	問	問	问			
Meet	逢	逢	逢			
Name	名	名	名			
Sound	音	音	音			
Say	言	言	言			
Write	文	文	文			
Start	始	始	始			
End	終	終	终			
Cover	包	包	包			
Sleep	眠	眠	眠			
Rest	休	休	休			
Stand	立	立	立	立		
Stay	待	待	待			
Plan	豫	予	豫			
Make	作	作	作			
Try	試	試	试			
Care	興	興	兴			
Grow	育	育	育			
Base	支	支	支			
Help	助	助	助			
Work	事	事	事			
Order	使	使	使			
Catch	取	取	取			
Have	持	持	持			
Stack	積	積	积			
Put	入	入	入			
Continue	續	続	续			
Result	出	出	出			
Send	投	投	投			
Give	與	与	与			
Get	受	受	受			
Trade	商	商	商			
Change	變	変	变			
Fit	適	適	适			
Live	生	生	生			
Die	死	死	死			
Sick	痛	痛	痛			
Hit	打	打	打			
Fight	戰	戦	战			
Win	成	成	成			
Control	治	治	治			
Choose	決	決	决			
List	順	順	顺			
Relate	關	関	关			
Connect	連	連	连	連		
Plus	加	加	加			
Minus	除	除	除			
Divide	分	分	分			
Break	破	破	破			
Mix	混	混	混			
Explode	爆	爆	爆			
Shake	波	波	波			
Go	行	行	行	行		
Come	來	来	来	來		
Push	引	引	引			
Follow	從	従	从			
Pass	過	過	过			
Carry	車	車	车	車		
Turn	回	回	回			
Stop	防	防	防			
Tie	束	束	束			
Free	解	解	解			
Exist	有	有	有			
In	內	內	内			
Out	外	外	外			
Up	上	上	上			
Down	下	下	下			
Middle	中	中	中			
Side	方	方	方			
Next	次	次	次			
Right	右	右	右			
Left	左	左	左			
Front	前	前	前			
Back	後	後	后			
Time	時	時	时			
Past	古	古	古			
Future	將	将	将			
Can	能	能	能			
Luck	運	運	运			
Maybe	若	若	若	若		
Become	爲	為	为			
Must	必	必	必			
Reason	由	由	由			
True	眞	真	眞			
False	假	仮	假			
Not	不	不	不	不		
Opposite	反	反	反			
Again	再	再	再			
Use	以	以	以			
Place	所	所	所			
From	發	発	发			
Aim	的	的	的			
What	何	何	何			